Konu	ISIM	GEN
Münhasıran	ISIM	GEN
ikinci	SAYI	GEN
el	ISIM	GEN
araç	ISIM	GEN
satışı	ISIM	GEN
yapan	FIIL	GEN
mecralardan	ISIM	GEN
pazarlama	FIIL	GEN
hizmeti	ISIM	GEN
alınması	ISIM	GEN
Türkiye	ÖZEL	ORG
Garanti	ISIM	ORG
Bankası	ISIM	GEN
A.Ş.’den	SAYI	ORG
alınan	FIIL	GEN
03/04/2018	SAYI	TAR
tarih	ISIM	GEN
ve	ISIM	GEN
940/39	SAYI	KAN
sayılı	ISIM	GEN
başvuru	ISIM	GEN
yazısının	ISIM	GEN
bir	SAYI	GEN
örneğine	ISIM	GEN
ilişikte	ISIM	GEN
yer	FIIL	GEN
verilmiştir ISIM	GEN

Banka	ISIM	GEN
başvurusunda	ISIM	GEN
belirtilen	ISIM	GEN
hususlara	ISIM	GEN
ilişkin	ISIM	GEN
varsa	FIIL	GEN
Bankanız	ISIM	GEN
görüşlerini	ISIM	GEN
içeren	FIIL	GEN
Bankanız	ISIM	GEN
yazısının	ISIM	GEN
25	SAYI	KAN
Nisan	OZEL	ZAM
2018	SAYI	KAN
tarihine	ISIM	GEN
kadar	ZAMAN	GEN
Birliğimize	ISIM	GEN
ulaştırılması	FIIL	GEN
ve	ISIM	GEN
yazının	SIFAT	GEN
bir	SAYI	GEN
nüshasının	ISIM	GEN
da	ISIM	GEN
aynı	ISIM	GEN
süre	ISIM	GEN
içinde	ISIM	GEN
bankacilik@tbb.org.tr	SAYI	GEN
adresine	ISIM	GEN
gönderilmesi	FIIL	GEN
hususunu	ISIM	GEN
bilgilerinize	ISIM	GEN
sunarım	ISIM	GEN

HAZİNE	SAYI	ORG
VE	ISIM	GEN
MALİYE	ISIM	ORG
BAKANLIĞI	ISIM	ORG
Vergi	ISIM	ORG
Denetim	ISIM	ORG
Kurulu	ISIM	ORG
Başkanlığı	ISIM	ORG
Boğaziçi	ISIM	ORG
Küçük	ISIM	GEN
Ve	ISIM	GEN
Orta	OZEL	GEN
Ölçekli	ISIM	GEN
Mükellefler	ISIM	GEN
Grup	ISIM	GEN
Başkanlığı ISIM	GEN
Sayı	SAYI GEN
:95001624-663.05-A-8721	SAYI	GEN
-E.21961	SAYI	GEN
18.06.2019	SAYI	TAR
Konu	ISIM	GEN
:Bilgi	ISIM	GEN
213	SAYI	KAN
sayılı	ISIM	GEN
VUK'un	ISIM	GEN
134	SAYI	KAN
ve	ISIM	GEN
müteakip	ISIM	GEN
maddeleri	ISIM	GEN
uyarınca	ISIM	GEN
yapılmakta	FIIL	GEN
olan	FIIL	GEN
bir	SAYI	GEN
vergi	ISIM	GEN
incelemesine	FIIL	GEN
esas	SIFAT	GEN
teşkil	ISIM	GEN
etmek	FIIL	GEN
üzere,	ISIM	GEN
aşağıda	ISIM	GEN
belirtilen	ISIM	GEN
hususlar	ISIM	GEN
ile	EDAT	GEN
ilgili	ISIM	GEN
olarak	FIIL	GEN
adı	ISIM	GEN
geçen	ISIM	GEN
kanunun	ISIM	GEN
148'inci	OZEL	KAN
maddesine	ISIM	GEN
göre	EDAT	GEN
gerekli	ISIM	GEN
bilgilerin	ISIM	GEN
bu	ZAMIR	GEN
yazımızın	ISIM	GEN
tebliğ	ISIM	GEN
tarihinden	ISIM	GEN
itibaren	ISIM	GEN
en	ISIM	GEN
geç	FIIL	GEN
15	SAYI	KAN
gün	ZAMAN	ZAM
içerisinde	ISIM	GEN
aşağıda	ISIM	GEN
belirtilen	ISIM	GEN
çalışma	FIIL	GEN
adresimize	ISIM	GEN
bildirilmesi	FIIL	GEN
gerekmektedir.	ISIM	GEN

TARES'e	SAYI	ORG
tescil	ISIM	GEN
edilmediğinden	FIIL	GEN
borç	ISIM	GEN
tutarı	ISIM	GEN
ve	ISIM	GEN
güvence	ISIM	GEN
tutarı	ISIM	GEN
rakamları	ISIM	GEN
arasında	ISIM	GEN
önemli	ISIM	GEN
farklılıklar	ISIM	GEN
oluşmaktadır.	ISIM	GEN

Bu	SAYI	GEN
itibarla,	ISIM	GEN
kamuoyunun	ISIM	GEN
doğru	SIFAT	GEN
bilgilendirilmesini	FIIL	GEN
teminen	SAYI	GEN
taşınır	FIIL	GEN

Aşağıda	SAYI	GEN
belirtilen	ISIM	GEN
bilgilerin	ISIM	GEN
çekinme	FIIL	GEN
sebebi	ISIM	GEN
bildirilmeden	FIIL	GEN
süresinde	ISIM	GEN
verilmemesi,	FIIL	GEN
eksik	ISIM	GEN
ya	ISIM	GEN
da	ISIM	GEN
yanıltıcı	FIIL	GEN
bilgi	ISIM	GEN
verilmesi	FIIL	GEN
halinde;	ISIM	GEN
VUK'un	ISIM	GEN
mükerrer	SIFAT	GEN
355'inci	OZEL	KAN
maddesine	ISIM	GEN
göre	EDAT	GEN
özel	ISIM	GEN
usulsüzlük	ISIM	GEN
cezası	ISIM	GEN
kesilerek	FIIL	GEN
yeniden	ISIM	GEN
süre	ISIM	GEN
belli	SIFAT	GEN
edilmek	FIIL	GEN
sureti	ISIM	GEN
ile	EDAT	GEN
tekrar	ISIM	GEN
bilgi	ISIM	GEN
vermeye	FIIL	GEN
davet	ISIM	GEN
edileceğinin,	FIIL	GEN
ikinci	SAYI	GEN
defada	ISIM	GEN
bilgi	ISIM	GEN
verilmemesi,	FIIL	GEN
eksik	ISIM	GEN
ya	ISIM	GEN
da	ISIM	GEN
yanıltıcı	FIIL	GEN
bilgi	ISIM	GEN
verilmesi	FIIL	GEN
hallerinde	ISIM	GEN
özel	ISIM	GEN
usulsüzlük	ISIM	GEN
cezasının	ISIM	GEN
iki	SAYI	GEN
kat	FIIL	GEN
olarak	FIIL	GEN
kesileceğinin	FIIL	GEN
ederim	ISIM	GEN

T.C.TİCARET	SAYI	ORG
BAKANLIĞI	SAYI	ORG
İç	SAYI	ORG
Ticaret	ISIM	ORG
Genel	ISIM	ORG
Müdürlüğü	ISIM	ORG
36306101-441	SAYI	KAN
TÜRKİYE	SAYI	ORG
BANKALAR	ISIM	ORG
BİRLİĞİNEN	ISIM	ORG
13	SAYI	KAN
34340	SAYI	KAN
Bilindiği	SAYI	GEN
üzere,	ISIM	GEN
teslimsiz	ISIM	GEN
taşınır	FIIL	GEN
rehin	ISIM	GEN
hakkının	ISIM	GEN
güvence	ISIM	GEN
olarak	FIIL	GEN
kullanımının	FIIL	GEN
yaygınlaştırılması,	SIFAT	GEN
bu	ZAMIR	GEN
rehne	SAYI	GEN
konu	ISIM	GEN
taşınırların	SAYI	GEN
kapsamının	ISIM	GEN
genişletilmesi,	FIIL	GEN
taşınır	FIIL	GEN
rehninde	SAYI	GEN
aleniyetin	ISIM	GEN
sağlanması	FIIL	GEN
ve	ISIM	GEN
28/10/2016	SAYI	TAR
01/01/2017	SAYI	TAR
6750	SAYI	KAN
sayılı	ISIM	GEN
Ticari	ISIM	GEN
İşlemlerde	ISIM	GEN
Taşınır	FIIL	GEN
Rehni	SAYI	GEN
Kanunu	OZEL	GEN
29871	SAYI	KAN
tarihi	ISIM	GEN
itibariyle	ISIM	GEN
yürürlüğe	ISIM	GEN
girmiştir ISIM	GEN

